8 4 0 0 0 9 0 1 8 0 0 0 9 0 0 8
0 4 9 0 0 0 0 1 0 0 0 0 0 0 0 0
0 4 0 0 8 0 0 1 0 9 0 0 0 0 0 0
0 4 0 0 0 0 7 1 0 0 0 0 8 0 0 0
8 5 6 6 6 6 6 10 6 6 6 6 6 6 6 6
0 0 9 0 0 0 0 1 0 0 8 0 0 0 0 9
0 8 0 0 0 0 0 1 0 0 0 8 0 0 0 0
9 0 0 0 0 0 0 1 0 0 0 0 0 0 0 0
0 0 8 0 0 0 0 1 9 0 0 0 0 0 0 8
0 0 0 0 9 8 0 1 0 0 0 9 0 0 0 0
8 0 0 9 0 0 0 1 0 0 0 0 0 0 0 0
0 9 0 0 0 8 0 1 0 0 0 0 0 0 0 8