27 3 3 3 3 3 3 3 3 3 3 3 3 3 3 3 4 4 4 4 4 4 10 16 8 4 4 4 4 4 4 4 4 4 4 4 4 4 4 4 4 4 4 4 4 4 4 4 4 4 
27 7 7 7 7 7 7 7 7 7 7 7 7 7 30 5 5 5 29 7 7 7 28 16 22 5 6 6 6 6 6 6 5 5 5 5 5 5 6 6 6 6 6 6 6 6 6 6 29 30 
27 7 7 7 7 7 7 7 7 7 7 7 7 7 28 12 13 12 27 7 7 7 28 16 12 12 12 12 12 12 12 12 12 12 12 12 12 12 12 12 12 12 12 12 12 12 12 12 27 28 
27 7 7 7 7 7 7 7 7 7 7 7 7 7 28 12 13 12 27 7 7 7 28 16 12 12 12 12 12 12 12 12 12 12 12 12 12 12 12 12 12 12 12 12 12 12 12 12 27 28 
27 7 7 7 7 7 7 7 7 7 7 7 7 7 28 12 13 12 27 7 7 7 28 16 12 12 12 12 12 12 12 12 12 12 12 12 12 12 12 12 12 12 12 12 12 12 12 12 27 28 
27 7 7 7 7 7 7 7 7 7 7 7 7 7 28 12 13 12 27 7 7 7 28 16 12 12 12 12 12 12 12 12 12 12 12 12 12 12 12 12 12 12 12 12 12 12 12 12 27 28 
27 7 7 7 7 7 7 7 7 7 7 7 7 7 28 12 13 2 27 7 7 7 28 16 12 12 12 12 12 12 12 12 12 12 12 12 12 12 12 12 12 12 12 12 12 12 12 12 27 28 
27 7 7 7 7 7 7 7 7 7 7 7 7 7 28 12 13 12 27 7 7 7 28 16 12 12 12 12 12 12 12 12 12 12 12 12 12 12 12 12 12 12 12 12 12 12 12 12 27 28 
27 7 7 7 7 7 7 7 7 7 7 7 7 7 28 12 13 1 27 7 7 7 28 16 12 12 12 12 12 12 12 12 12 12 12 12 12 12 12 12 12 12 12 12 12 12 12 12 27 28 
27 7 7 7 7 7 7 7 7 7 7 7 7 7 28 12 13 12 27 7 7 7 28 16 12 12 12 12 12 12 12 12 12 12 12 12 12 12 12 12 12 12 12 12 12 12 12 12 27 28 
27 7 7 7 7 7 7 7 7 7 7 7 7 7 28 12 13 12 27 7 7 7 28 16 12 12 12 12 12 12 12 12 12 12 12 12 12 12 12 12 12 12 12 12 12 12 12 12 27 28 
27 7 7 7 7 7 7 7 7 7 7 7 7 7 28 12 13 2 27 7 7 7 28 16 12 12 12 12 12 12 12 12 12 12 12 12 12 12 12 12 12 12 12 12 12 12 12 12 27 28 
27 7 7 7 7 7 7 7 7 7 7 7 7 7 28 12 13 12 9 5 5 5 11 16 12 12 12 12 12 12 12 12 12 12 12 12 12 12 12 12 12 12 12 12 12 12 12 12 27 28 
27 7 7 7 7 7 7 7 7 7 7 7 7 7 28 12 13 12 12 12 12 12 1 16 12 12 12 12 12 12 12 12 12 12 12 12 12 12 12 12 12 12 12 12 12 12 12 12 27 28 
27 7 7 7 7 7 7 7 7 7 7 7 7 7 28 12 14 15 15 15 15 15 15 0 15 15 15 15 15 15 15 15 15 15 15 15 15 15 15 15 15 15 15 15 15 15 15 15 27 28 
27 7 7 7 7 7 7 7 7 7 7 7 7 7 31 24 24 24 26 12 12 25 26 16 12 12 12 12 12 12 12 12 12 12 12 12 12 12 12 12 12 12 12 12 12 12 12 12 27 28 
27 7 7 7 7 7 7 7 7 7 7 7 7 7 7 7 7 7 28 12 12 27 28 16 12 12 12 12 12 12 12 12 12 12 12 12 12 12 12 12 12 12 12 12 12 12 12 12 27 28 
27 7 7 7 7 7 7 7 7 7 7 7 7 7 7 7 7 7 28 12 12 27 28 16 12 12 12 12 12 12 12 12 12 12 12 12 12 12 12 12 12 12 12 12 12 12 12 12 27 28 
27 7 7 7 7 7 7 7 7 7 7 7 7 7 7 7 7 7 28 12 12 27 28 16 12 12 12 12 12 12 12 12 12 12 12 12 12 12 12 12 12 12 12 12 12 12 12 12 27 28 
27 7 7 7 7 7 7 7 7 7 7 7 7 7 7 7 7 7 28 12 12 27 28 16 12 12 12 12 12 12 12 12 12 12 12 12 12 12 12 12 12 12 12 12 12 12 12 12 27 28 
27 7 7 7 7 7 7 7 7 7 7 7 7 7 7 7 7 7 28 12 12 27 28 16 12 12 12 12 12 12 12 12 12 12 12 12 12 12 12 12 12 12 12 12 12 12 12 12 27 28 
27 7 7 30 5 5 5 5 5 5 5 5 5 6 6 6 6 6 11 12 1 27 28 16 12 12 12 12 12 12 12 12 12 12 12 12 12 12 12 12 12 12 12 12 12 12 12 12 27 28 
27 7 30 23 12 12 12 12 12 12 12 12 12 12 12 12 12 12 2 12 12 27 28 16 12 12 12 12 12 12 12 12 12 12 12 12 12 12 12 12 12 12 12 12 12 12 12 12 27 28 
27 7 28 12 12 12 12 12 12 12 1 12 12 12 12 12 12 2 12 12 1 27 28 16 12 12 12 12 12 12 12 12 12 12 12 12 12 12 12 12 12 12 12 12 12 12 12 12 27 28 
27 7 28 12 2 12 12 12 12 12 12 12 12 12 12 12 12 12 12 12 12 27 28 16 12 12 12 12 12 12 12 12 12 12 12 12 12 12 12 12 12 12 12 12 12 12 12 12 27 28 
27 7 28 12 12 1 12 12 12 12 12 12 12 12 12 12 12 12 12 12 12 27 28 16 12 12 12 12 12 12 12 12 12 12 12 12 12 12 12 12 12 12 12 12 12 12 12 12 27 28 
27 7 28 12 12 12 12 12 12 12 12 12 12 12 12 12 12 2 12 12 12 27 28 16 12 12 12 12 12 12 12 12 12 12 12 12 12 12 12 12 12 12 12 12 12 12 12 12 27 28 
27 7 28 12 12 12 12 12 12 12 1 12 12 12 12 2 12 12 12 12 12 27 28 16 12 12 12 12 12 12 12 12 12 12 12 12 12 12 12 12 12 12 12 12 12 12 12 12 27 28 
27 7 28 12 12 12 12 12 12 12 12 12 12 12 12 12 12 12 12 12 2 27 28 16 12 12 12 12 12 12 12 12 12 12 12 12 12 12 12 12 12 12 12 12 12 12 12 12 27 28 
27 7 28 12 12 12 12 12 12 12 12 12 12 12 2 12 12 12 12 12 12 27 28 16 12 12 12 12 12 12 12 12 12 12 12 12 12 12 12 12 12 12 12 12 12 12 12 12 27 28 
27 7 28 1 12 12 12 1 12 12 12 12 12 12 12 12 12 12 12 12 12 27 28 16 12 12 12 12 12 12 12 12 12 12 12 12 12 12 12 12 12 12 12 12 12 12 12 12 27 28 
27 7 28 2 12 12 12 12 12 12 12 12 12 12 12 12 12 1 12 12 12 27 28 16 12 12 12 12 12 12 12 12 12 12 12 12 12 12 12 12 12 12 12 12 12 12 12 12 27 28 
27 7 28 12 12 12 12 12 12 12 12 12 12 12 12 12 12 12 12 12 12 27 28 16 12 12 12 12 12 12 12 12 12 12 12 12 12 12 12 12 12 12 12 12 12 12 12 12 27 28 
27 7 28 12 12 12 12 12 12 12 12 12 12 12 12 12 12 12 12 12 12 27 28 16 12 12 12 12 12 12 12 12 12 12 12 12 12 12 12 12 12 12 12 12 12 12 12 12 27 28 
27 7 28 12 12 12 12 12 12 12 12 12 12 12 12 12 12 12 12 12 12 27 28 16 12 12 12 12 12 12 12 12 12 12 12 12 12 12 12 12 12 12 12 12 12 12 12 12 27 28 
27 7 28 12 12 12 12 12 2 12 12 12 12 12 1 12 12 12 1 12 12 27 28 16 12 12 12 12 12 12 12 12 12 12 12 12 12 12 12 12 12 12 12 12 12 12 12 12 27 28 
27 7 28 2 12 12 12 12 12 12 12 12 12 12 12 12 12 12 12 12 2 27 28 16 12 12 12 12 12 12 12 12 12 12 12 12 12 12 12 12 12 12 12 12 12 12 12 12 27 28 
27 7 28 12 12 1 1 1 1 1 1 1 1 1 12 12 2 12 12 12 12 27 28 16 12 12 12 12 12 12 12 12 12 12 12 12 12 12 12 12 12 12 12 12 12 12 12 12 27 28 
27 7 28 12 12 1 12 12 1 1 1 1 1 1 1 12 12 12 12 12 12 27 28 16 12 12 12 12 12 12 12 12 12 12 12 12 12 12 12 12 12 12 12 12 12 12 12 12 27 28 
27 7 28 12 12 1 12 1 1 12 2 12 12 1 1 1 12 12 12 12 12 27 28 16 12 12 12 12 12 12 12 12 12 12 12 12 12 12 12 12 12 12 12 12 12 12 12 12 27 28 
27 7 28 12 12 12 1 1 12 12 12 12 12 12 12 1 2 12 12 1 12 27 28 16 12 12 12 12 12 12 12 12 12 12 12 12 12 12 12 12 12 12 12 12 12 12 12 12 27 28 
27 7 28 2 12 12 12 12 1 1 1 1 1 1 1 1 12 12 12 12 12 27 28 16 12 12 12 12 12 12 12 12 12 12 12 12 12 12 12 12 12 12 12 12 12 12 12 12 27 28 
27 7 28 12 1 1 1 1 12 12 12 2 12 12 12 1 12 12 12 12 12 27 28 16 12 12 12 12 12 12 12 12 12 12 12 12 12 12 12 12 12 12 12 12 12 12 12 12 27 28 
27 7 28 1 12 12 12 12 12 12 12 12 12 12 12 12 12 2 12 12 1 27 28 16 12 12 12 12 12 12 12 12 12 12 12 12 12 12 12 12 12 12 12 12 12 12 12 12 27 28 
27 7 28 12 12 12 1 12 12 12 12 12 12 12 12 12 12 12 12 12 12 27 28 16 12 12 12 12 12 12 12 12 12 12 12 12 12 12 12 12 12 12 12 12 12 12 12 12 27 28 
27 7 28 12 2 12 12 12 12 12 12 12 12 2 12 12 12 12 12 12 12 27 28 16 12 12 12 12 12 12 12 12 12 12 12 12 12 12 12 12 12 12 12 12 12 12 12 12 27 28 
27 7 28 1 12 12 12 12 12 2 12 12 12 12 12 1 12 12 12 12 12 27 28 16 12 12 12 12 12 12 12 12 12 12 12 12 12 12 12 12 12 12 12 12 12 12 12 12 27 28 
27 7 31 24 24 24 24 24 24 24 24 24 24 24 24 24 24 24 24 24 24 24 28 16 25 24 24 24 24 24 24 24 24 24 24 24 24 24 24 24 24 24 24 24 24 24 24 24 24 28 
27 7 7 7 7 7 7 7 7 7 7 7 7 7 7 7 7 7 7 7 7 7 28 16 27 7 7 7 7 7 7 7 7 7 7 7 7 7 7 7 7 7 7 7 7 7 7 7 7 28 
22 5 5 5 5 5 5 5 5 5 5 5 5 5 5 5 5 5 5 5 5 5 23 16 22 6 6 6 6 6 6 6 6 6 5 5 5 5 5 5 5 5 5 5 6 6 6 6 5 23 
